01003220
01001221
01101101
01101100
00122101
00122221
02322222
00000000
0,0
0,4